#.##############
#-#---#--------#
#-###-#-##-###-#
#-----#--#-#-#-#
####-###-###-#-#
#--#-###--##-#-#
#----#----##---#
####-###--####-#
#----###-##--#-#
#-##--##-###-#-#
#---#-##---#-#-#
#####-##-###-#-#
#--------#---#-#
#####-#-####-#-#
#-----##-------#
#-#-#-#--##--###
###-###-###-####
#------#---@#--#
#-######-####-##
#-----##------$#
################