#############################.#
#--$##########----------------#
#-##############-######-#####-#
#-----------####-######-------#
##-########-####-########-----#
#--#---####-####-##############
#-####-####-####-------------##
#-#-------#-##########--####-##
#-#-#######---########-########
#-#-----#####-########------###
#-#####-#####-##########-##---#
#-------##----######------#####
###-######-#####-----####-#####
###-######-##############-#####
#@---------------------------##
###############################